genuine - prawdziwe
appeal to - odpowiadać komuś
habitable - badający się do zamieszkania
viable - zdolny do życia
enterprise - przedsiębiorstwo
entrepreneur - przedsiębiorca
cohabitate - współmieszkaniec
long shot - trudne
convincing - przekonujące
convince - przekonać
convinced - przekonany
mole - kret
selfsufficient - samowystarczalny
to sprawl - rozciągać się
illadvised - nierozważny
boycott - blokować
timeless - ponadczasowy
pagoda - wieża buddyjska
glimps - ujrzeć
boast - przechwałki
cherrished - ceniony
pristine - dziewiczy
indigenous - rodzimy, rodowity
manned - załogowy
uninhabitable - niezamieszkalny
lethal - śmiertelny
feasible - wykonalny
unprecedented - bez precedensu
bunks - prycze
cot - łóżko składane
appealing - pociągający
to spill out - dać duży rezultat
operational - działający
mulched - rozczłomkowany
sweltering - upalny
carcinogenic - rakotwórcze
to divert - zmienić kierunek
celestial - niebiański
disappear off the face of the earth - zniknąć całkowicie
promise the stars - nierealne obietnice
over the moon - wniebowzięty
go skyhigh - bardzo wysokie
once in a blue moon - rzadko
pie in the sky - nierealne marzenia
on earth - do cholery
rocket science - trudna technologia
see stars - widzieć gwiazdy
lucky star - szczęśliwiec
down to earth - sprawdzony na ziemię
under a cloud - być w kłopotach
reach for the stars - sięgnąć gwiazd
be on antoher planer - być nie z tej ziemi
interviewee - osoba poddana wywiadowi
shortlisted - zakwalifikowany
adverse conditions - niekorzystne warunki
on the downside - złe strony
